1111111111111
1001000000C1
1000011110001
1P0011E000001
1111111111111