NO ./textures/wallSO.xpm
SO ./textures/wallSO.xpm
WE ./textures/wallSO.xpm
EA ./textures/wallSO.xpm

F 53, 61, 53
C 59, 21, 21

1111111111111111111111111
1000000000110000000000001
1011011101111011111111111
100100000000000000000000111111111
111111111011011101110000000000001
100000000011011101110111111111111
11110111111111010000000010S01
11110111111111011101010010001
11110000110101011100000010001
10000111111111100000000010H01
10110000000000001111010010001
1000111111010101111101111121111
11100111 1110101 100000000001
11111111 1111111 111111111111