111111111111111111111111111111
1P000001C1000000000010001000C1
111111010111000000001000000001
1000000100000C0100100000E00001
100010000111101001111000V00001
10C01000001C0001000C10000001C1
111111111111111111111111111111
